2;2;2;2;2;2;2;2
2;2;2;2;2;2;2;2
2;2;1;1;2;2;2;2
2;2;0;0;1;2;2;2
2;2;2;1;3;3;3;2
2;2;2;3;4;4;3;2
2;2;2;2;3;4;3;2
2;2;2;2;2;2;2;2