Oh no. Winter is coming.
002;002;002;002;002;001;000;000
002;002;002;002;002;002;000;000
002;002;002;002;002;002;000;000
002;002;002;002;002;002;000;000
102;002;002;002;002;002;000;000
102;102;002;002;002;001;000;000
102;102;102;002;002;001;000;000
112;102;102;102;002;001;000;000