
002;002;002;002;001;100;100;100
002;002;002;002;001;100;100;100
002;002;002;002;001;100;100;100
002;002;002;002;001;100;100;100
102;002;002;002;001;100;100;101
102;102;002;002;001;100;101;101
102;102;102;002;001;100;101;101
112;102;102;102;001;100;101;101