
003;003;010;010;010;010;001;002;002
003;003;010;010;010;010;001;002;002
000;003;010;010;010;010;001;002;002
103;003;010;010;101;101;001;002;003
113;103;010;010;101;010;001;002;003
113;103;101;101;101;010;001;002;003