
002;002;002;010;010;010;010;010;002;002
102;002;002;010;010;010;010;010;002;002
102;102;002;010;010;010;010;010;002;002
102;102;001;101;101;101;010;010;002;003
102;102;002;010;010;101;010;010;003;000
112;102;102;010;010;101;101;101;003;000