"Easy!"
2;2;2;2;2;2
2;2;3;1;2;2
2;2;2;2;2;2
2;2;2;2;2;2
2;2;2;2;2;3
0;2;2;2;3;-3