"Disturbing!"
3;3;3;5;.;.;.;.
3;4;3;.;.;.;.;.
3;3;3;.;.;.;.;.
.;.;0;.;.;.;.;.
.;.;0;.;.;.;.;.
.;.;0;0;0;3;4;4
.;.;.;.;.;4;5;5
.;.;.;.;.;4;5;5